1111111111
1000000001
1001001001
1000001001
1001001001
1000001001
1010001001
1000001001
1010001001
1000001001
100$001101
1000001001
1011001001
1001001001
1111111111	
